????????????????????????????
?........####..............?
?........####..............?
?........##......@@@@@@....?
?@@..##..##..........@@....?
?@@..##......##............?
?@@..##......##............?
?##..######..####..~~~~..~~?
?##..######..####..~~~~..~~?
?##......##........~~......?
?..................~~......?
?........~~~~..~~~~~~..####?
?....##..~~~~..~~~~~~..####?
?####....~~##..###.........?
?####....~~##..###.........?
?........~~...........@@...?
?........~~...........@@...?
?~~~~~~..~~..@@..##...@....?
?~~~~~~..~~..@@..##...@....?
?.....................@####?
?......####...........@####?
?........##########........?
?........##......####......?
?######............####....?
?####.......####.....##....?
?##.........#..#...........?
?...........#..#...........?
????????????????????????????
