????????????????????????????
?..........................?
?..........................?
?...#####............#####.?
?...#..##............##..#.?
?.###....##..%%%%..##.....#?
?.#......##..%%%%..##.....#?
?##......##%%%%%%%%##.....#?
?##......##%%%%%%%%##.....#?
?##.....###%%@@@@%%###...##?
?##.....###%%@@@@%%###...##?
?.#....##~~~~~~~~~~~~######?
?.#######~~~~~~~~~~~~######?
?..######@@@@##@@@@#######.?
?..######@@@@##@@@@#######.?
?....####@@..##..@@#####...?
?....####@@..##..@@#####...?
?....###################...?
?....###################...?
?##%%######@@@@########%%##?
?##%%......@@@@........%%##?
?##%%%%%%%%%%%%%%%%%%%%%%##?
?##%%%%%%%%%%%%%%%%%%%%%%##?
?....%%%%%%......%%%%%%%%..?
?....%%%%%%.####.%%%%%%%%..?
?......#....#..#.....#.....?
?......#....#..#.....#.....?
????????????????????????????