????????????????????????????
?..............######......?
?..............######......?
?..######..........##......?
?..########..##....##......?
?........##..##........####?
?........##............####?
?..~~~~~~~~~~..###.....##@@?
?..~~~~~~~~~~..###.....##..?
?..........~~..##..@@@.##..?
?....@@@@@@~~..##..@@@.##..?
?##..######~~~~~~..~~####..?
?##..######~~~~~~..~~####..?
?........@@~~......~~@@....?
?........@@~~......~~......?
?~~~~~~..~~~~####..~~......?
?~~~~~~..~~~~####..~~......?
?..........##@@@@..~~~~~~..?
?..........##......~~~~~~..?
?######....................?
?######....................?
?....##..@@@@......####...#?
?....##............####...#?
?##................##....##?
?##.........####...##....##?
?...........#..#...........?
?...........#..#...........?
????????????????????????????