????????????????????????????
?......~~..##....##..##....?
?......~~..##....##..##....?
?................##..@@....?
?................##..@@....?
?......~~....@@..##..##....?
?......~~..##@@..##..##....?
?@@..##~~..@@....##..##....?
?....##~~..@@..##....##....?
?....##~~......##..........?
?....##~~......##..........?
?##..##~~~~..~~~~~~~~....##?
?##..##~~~~..~~~~~~~~....##?
?..............%%..~~..@@@@?
?......##......%%..~~......?
?####.###..@@%%%%%%~~......?
?####.###..@@%%%%%%~~..####?
?##...#....##%%%%%%~~..##..?
?.....#....##%%%%%%~~..##..?
?..........##..%%..~~..%%..?
?..@@......##..%%..~~..%%..?
?..##......######....%%%%%%?
?..##..@@............%%%%%%?
?..##..##..........~~%%%%%%?
?..##..##...####...~~%%%%%%?
?...........#..#...~~..%%..?
?...........#..#...~~..%%..?
????????????????????????????