????????????????????????????
?..........%%..............?
?..........%%..............?
?........%%@@%%............?
?........%%@@%%............?
?....%%....%%....%%%%......?
?....%%....%%....%%%%......?
?..%%##%%......%%####%%....?
?..%%##%%......%%####%%....?
?....%%##%%......%%%%....%%?
?....%%##%%......%%%%....%%?
?%%....%%....%%........%%@@?
?%%....%%....%%........%%@@?
?##%%......%%@@%%....%%..%%?
?##%%......%%@@%%....%%..%%?
?@@##%%......%%....%%@@%%..?
?@@##%%......%%....%%@@%%..?
?##%%....%%......%%..%%....?
?##%%....%%......%%..%%....?
?%%....%%##%%..%%##%%......?
?%%....%%##%%..%%##%%......?
?......%%##%%....%%....%%..?
?......%%##%%....%%....%%..?
?..%%....%%..........%%@@%%?
?..%%....%%.####.....%%@@%%?
?%%@@%%.....#..#...%%##%%..?
?%%@@%%.....#..#...%%##%%..?
????????????????????????????