????????????????????????????
?...........#..#.%%%%......?
?...........#..#.%%%%......?
?..#..@..#........#%%#..#%%?
?..#..@..#........#%%#..#%%?
?..#..@..#...##...#%%#..#%%?
?..#..@..#...##...#%%#..#%%?
?..##....##..@@..##%%..##%%?
?..##....##..@@..##%%..##%%?
?.......#@@..##..##@...%%%%?
?.......#....##....@...%%%%?
?#####.....%%##%%.....#####?
?#####.....%%##%%.....#####?
?.........#%%%%%%#.........?
?.........#%%%%%%#.........?
?@@####..##%%%%%%##.#####@@?
?@@####....%%%%%%...#####@@?
?@@@@@@......%%......@@@@@@?
?........##..%%..##........?
?..##....##......##........?
?..##....##......##........?
?..###.....##..##.....###%%?
?..###................###%%?
?....##..............%%%%%%?
?...........####.....%%%%%%?
?...........#..#.......%%%%?
?....##.....#..#.....##%%%%?
????????????????????????????
