????????????????????????????
?..............@@@@........?
?..........................?
?..@@@@@@@@........@@......?
?..@@..............@@......?
?..@@......%%..@@@@@@......?
?..@@......%%....@@@@......?
?..@@......%%@@......@@....?
?..@@......%%@@......@@....?
?........%%@@@@......@@@@..?
?........%%@@@@........@@..?
?..@@..%%@@@@@@..@@........?
?..@@..%%@@@@@@..@@........?
?...@..@@@@......@@@@......?
?...@..@@@@......@@@@......?
?@.......@@..@@@@@@.....@..?
?@.......@@..@@@@@@.....@..?
?...@@@......@@@@%%....@@..?
?...@@@......@@@@%%....@@..?
?..@@........@@%%....@@@@..?
?..@@........@@%%....@@@@..?
?..@@@@@@....%%....@@......?
?......@@....%%....@@......?
?..................@@....@@?
?...........####.......@@@@?
?...........#..#...........?
?@@@@.......#..#...........?
????????????????????????????