????????????????????????????
?..........@@..##..####....?
?..........@@..##..####....?
?...#########..##..........?
?...#########..##..........?
?......#...##..####..%%%%%%?
?......#...##..####..%%%%%%?
?...#..........@@..%%%%%%%%?
?...#..........@@..%%%%%%%%?
?...#..######@@####%%%%##@@?
?...#..######@@####%%%%..@@?
?..######@@....##..%%%%...#?
?........@@....##..%%%%...#?
?.#######..@@%%%%%%%%%%....?
?.#######..@@%%%%%%%%%%....?
?......@@....%%%%%%%%%%##..?
?......@@....%%%%%%%%%%##..?
?@@##..%%%%%%%%@@%%%%%%##..?
?@@##..%%%%%%%%@@%%%%%%##..?
?.###%%%%%%%%%%........###.?
?.###%%%%%%%%%%........###.?
?..##%%%%........@@######..?
?..##%%%%..........######..?
?....%%%%..........##...#..?
?....%%%%...####...##...#..?
?....%%%%...#..#...........?
?..##%%%%...#..#...........?
????????????????????????????