????????????????????????????
?..........................?
?..........................?
?%%%%......######......%%%%?
?%%%%....##########....%%%%?
?%%.....############.....%%?
?%%.....############.....%%?
?......####%%##%%####......?
?......####%%##%%####......?
?......##%%%%##%%%%##......?
?......##%%%%##%%%%##......?
?%%....##############....%%?
?%%....##############....%%?
?%%%%....##%%##%%##....%%%%?
?%%%%....##%%##%%##....%%%%?
?~~~~~~..##########..~~~~~~?
?~~~~~~..##########..~~~~~~?
?.........#.#.#.#.#........?
?.........#.#.#.#.#........?
?........#.#.#.#.#.........?
?........#.#.#.#.#.........?
?.@.@.@..............@.@.@.?
?.@.@.@..............@.@.@.?
?#.#.#................#.#.#?
?#.#.#......####......#.#.#?
?.@.@.@..@...#..#...@..@.@.?
?.@.@.@..@...#..#...@..@.@.?
????????????????????????????