????????????????????????????
?........####....##........?
?........####....##........?
?..%%%%####......##........?
?..%%%%####......##........?
?%%%%%%%%%%%%%%%%####......?
?%%%%%%%%%%%%%%%%####......?
?%%@@##%%######%%%%%%%%##@@?
?%%..##%%######%%%%%%%%##@@?
?%%%%##%%%%%%@@%%%%##@.##..?
?%%%%##%%%%%%..%%%%##@.##..?
?..%%%%##..%%%%%%%%##..##..?
?..%%%%##@@%%%%%%%%##..##..?
?..##########%%%%#####.%%%%?
?..##########%%%%#####.%%%%?
?.@@@####......####......%%?
?.@..####......##........%%?
?..##..##......##%%%%###.%%?
?..##..##....##..%%%%###.%%?
?..##......@@##%%%%##....%%?
?..##.....###..%%%%##....%%?
?..#####..###%%%%..%%##%%%%?
?..#####..###%%%%##%%##%%%%?
?...##...#......##%%##%%...?
?...##..%%.####.##%%..%%...?
?...##..%%.#..#...%%%%%%...?
?...........#..#...%%%%%%..?
????????????????????????????