????????????????????????????
?..##..##..##..##..##..##..?
?..##..##..##..##..##..##..?
?..##..##..##..##..##..##..?
?..##..##..##..##..##..##..?
?..@@..@@..@@..@@..@@..@@..?
?..........................?
?........##......##........?
?##..##..##......##..##..##?
?##..######..##..######..##?
?##..##..##..##..##..##..##?
?@@..@@..@@..@@..@@..@@..@@?
?........@@......@@........?
?%%%%....##..%%..##....%%%%?
?%%%%....##..%%..##....%%%%?
?%%%%%%%%####%%####%%%%%%%%?
?%%%%%%%%##..%%..##%%%%%%%%?
?%%%%%%%%%%%%%%%%%%%%%%%%%%?
?%%%%%%%%%%%%%%%%%%%%%%%%%%?
?........##%%%%%%##........?
?##..##..##%%%%%%##..##..##?
?..##..##....%%....##..##..?
?..##..##....%%....##..##..?
?..##..##..........##..##..?
?..##..##...####...##..##..?
?..##..##...#..#...##..##..?
?...........#..#...........?
????????????????????????????