????????????????????????????
?..........................?
?......######....##........?
?....################......?
?..##################......?
?..%%%%%%%%%%%%%%%%####....?
?..%%%%%%%%%%%%%%%%####....?
?%%%%............%%%%####..?
?%%%%............%%%%####..?
?%%..@@....@@......%%%%%%..?
?%%..@@....@@......%%%%%%..?
?%%..@@....@@......%%%%%%..?
?%%..@@....@@......%%%%%%..?
?%%....%%........%%%%#####.?
?%%....%%........%%%%#####.?
?%%%%%%%%%%%%%%%%%%#######.?
?%%%%%%%%%%%%%%%%%%#######.?
?##%%%%####%%%%%%########..?
?##%%%%####%%%%%%########..?
?..####################..@@?
?..####################..@@?
?@@..##@@#############...@@?
?@@..##@@#############...@@?
?..@@####@@......####@@@@@@?
?..@@##..@@.####.####@@@@@@?
?...........#..#...........?
?...........#..#...........?
????????????????????????????