????????????????????????????
?..........................?
?..........................?
?..........@@@@............?
?..........@@@@............?
?............@@............?
?............@@............?
?..@@@@%%%%##@@##%%%%@@@@..?
?..@@@@%%%%##@@##%%%%@@@@..?
?......@@%%%%@@%%%%@@......?
?......@@%%%%@@%%%%@@......?
?%%......@@%%%%%%@@......%%?
?%%......@@%%%%%%@@......%%?
?@@%%......%%%%%%......%%@@?
?@@%%......%%%%%%......%%@@?
?%%........@@%%@@........%%?
?%%......@@..%%..@@......%%?
?........@@......@@........?
?........@@..@@..@@........?
?......@@....@@....@@......?
?......@@....@@....@@......?
?..........................?
?..........................?
?..........................?
?...........####...........?
?....@@.....#..#.....@@....?
?....@@.....#..#.....@@....?
????????????????????????????