????????????????????????????
?......@@..##..##..##..@@..?
?......@@..##..##..##..@@..?
?..##..##..........@@......?
?..##..##..........@@......?
?..##..##....@@....@@..@@@@?
?..##..##....@@....@@..@@@@?
?..##......##..@@##......@@?
?..##......##..@@##......@@?
?........####..####..@@....?
?........####..####..@@....?
?....@@..##....####..####..?
?....@@..##....####..####..?
?@@..@@....##..@@....@@##..?
?@@..@@....##..@@....@@##..?
?....####..##......##@@....?
?....####..##......##@@....?
?..@@####..####..####....##?
?..@@####..####..####....##?
?..##......##@@........####?
?..##......##@@........####?
?......##..####@@..@@....##?
?......##..####@@..@@....##?
?##..####..........##@@....?
?##..####...####...##@@....?
?##..##.....#..#...######..?
?##..##.....#..#...######..?
????????????????????????????