????????????????????????????
?....~~~~..................?
?....~~~~..................?
?......~~%%..#.............?
?@@....~~%%..#.............?
?%%..........@...#...~~~~..?
?%%@@........@...#...~~~~..?
?%%%%..@@...#....@.%%~~....?
?%%%%....##.#....@.%%~~....?
?%%%%%%....@@...#..........?
?%%%%%%....@@##.#........@@?
?%%%%@@.....#..@@........%%?
?%%%%..@@...#..@@##....@@%%?
?%%@@....##@@...#..@@..%%%%?
?%%........@@...#......%%%%?
?..........#.##@@....%%%%%%?
?..........#...@@....%%%%%%?
?....~~%%.@....#.##..@@%%%%?
?....~~%%.@....#...@@..%%%%?
?..~~~~...#...@..........%%?
?..~~~~...#...@..........%%?
?.............#..%%~~....@@?
?.............#..%%~~......?
?@@................~~~~....?
?@@.........####...~~~~....?
?@@@@.......#..#.........@@?
?@@@@.......#..#.........@@?
????????????????????????????