????????????????????????????
?........@@................?
?........@@................?
?@@@@....@@....@@@@........?
?@@@@....@@....@@@@........?
?..@@....@@......@@..@@@@%%?
?..@@....@@......@@..@@@@%%?
?..@@....@@@@@@..%%..@@....?
?..@@....@@@@@@..%%..@@....?
?..##........@@..@@@@@@....?
?..##........@@..@@@@@@....?
?%%@@@@..@@##@@####........?
?%%@@@@..@@##@@####........?
?....@@%%@@%%....##....@@@@?
?....@@%%@@%%....##....@@@@?
?....@@....%%....@@....@@..?
?....@@....%%....@@....@@..?
?....##....@@....@@@@##@@..?
?....##....@@....@@@@##@@..?
?%%@@@@@@%%%%##@@@@..##@@..?
?%%@@@@@@%%%%##@@@@..##@@..?
?......##........%%%%..##..?
?......##........%%%%..##..?
?......@@..........%%..##..?
?......@@...####...%%..##..?
?......@@...#..#...@@..##..?
?......@@...#..#...@@..##..?
????????????????????????????