????????????????????????????
?.....................@@...?
?.....................@@...?
?....................@@....?
?............@@......@@....?
?............%%....###.....?
?..........##%%##..###.....?
?..........%%%%%%..###.....?
?........@@%%%%%%@@###.....?
?........%%%%--%%%%###.....?
?......##%%%%--%%%%###.....?
?......%%%%------%%%%#.....?
?....@@%%%%------%%%%#.....?
?....%%%%----------%%%%....?
?..##%%%%----------%%%%##..?
?..%%%%--------------%%%%..?
?@@%%%%--------------%%%%@@?
?%%%%------------------%%%%?
?%%%%------------------%%%%?
?..%%------------------%%..?
?..%%------------------%%..?
?..%%------------------%%..?
?..%%------------------%%..?
?..%%------......------%%..?
?..%%------.####.------%%..?
?..%%----...#..#...----%%..?
?..%%----...#..#...----%%..?
????????????????????????????