????????????????????????????
?......~~........~~........?
?......~~........~~........?
?~~~~..~~..~~~~~~~~..~~~~~~?
?~~~~..~~..~~~~~~~~..~~~~~~?
?%%%%##....##....~~..~~%%~~?
?%%%%##....##....~~..~~%%~~?
?%%~~~~~~~~..@@....##%%%%%%?
?%%~~~~~~~~..@@....##%%%%%%?
?%%%%..~~....~~..~~~~~~~~%%?
?%%%%..~~....~~..~~~~~~~~%%?
?~~~~..~~..~~~~....~~......?
?~~~~..~~..~~~~....~~......?
?....##%%##..##%%..~~....~~?
?....##%%##..##%%..~~....~~?
?..~~~~%%~~~~~~~~..%%##..~~?
?..~~~~%%~~~~~~~~..%%##..~~?
?##....##....~~..%%%%~~..~~?
?##....##....~~..%%%%~~..~~?
?~~~~..~~~~..~~##~~~~~~....?
?~~~~..~~~~..~~##~~~~~~....?
?....##..%%%%....%%~~....~~?
?....##..%%%%....%%~~....~~?
?..~~~~~~%%........~~..~~~~?
?..~~~~~~%%.####...~~..~~~~?
?..~~.......#..#...........?
?..~~.......#..#...........?
????????????????????????????
