????????????????????????????
?........#..#..............?
?........#..#..............?
?#.#.#..#..#.....#.#.......?
?#.#.#..#..#.....#.#.......?
?#.#.#.####......#.###.....?
?#.#.#.####......#.###.....?
?.#.#..###......##.####....?
?.#.#..###......##.####....?
?..#...##.##...#.######....?
?..#...##.##...#.######....?
?..#..#....###.##.#.###....?
?..#..#....###.##.#.###....?
?..#......######...#.##....?
?..#......######...#.##....?
?...#....#.#####...#.##....?
?...#....#.#####...#.##....?
?...#####..######..#.#.####?
?...#......######..#.#...##?
?...#.....##.##.##.#.#..#.#?
?...#.....##.##.##...#..#.#?
?....#...##.##.####.....#..?
?....#...##.##.####.....#..?
?....#..##.......###...#...?
?....#..##..####.###...#...?
?....#..#...#..#...####....?
?....#..#...#..#...####....?
????????????????????????????