????????????????????????????
?..........................?
?..........................?
?..........................?
?..........................?
?..........................?
?..........................?
?..........................?
?..........................?
?..........................?
?..........................?
?..........................?
?..........................?
?..........................?
?..........................?
?..........................?
?..........................?
?..........................?
?..........................?
?..........................?
?..........................?
?..........................?
?..........................?
?..........................?
?...........@@@@...........?
?...........@@%@...........?
?...........@%@@...........?
????????????????????????????