????????????????????????????
?......@@......@@..........?
?......@@......@@..........?
?..##..@@......##..##..##..?
?..##..@@......##..##..##..?
?..##..........##..##@@##..?
?..##........####..##@@##..?
?......##..........@@......?
?......##..........@@......?
?%%....##....@@....##%%##@@?
?%%....##....@@....##%%##@@?
?%%%%......##....@@..%%....?
?%%%%......##....@@..%%....?
?..######%%%%%%@@....%%##..?
?..######%%%%%%@@....%%##..?
?......@@%%##..##..##..##..?
?......@@%%##..##..##..##..?
?@@##..@@..##..##......##..?
?@@##..@@..##..##......##..?
?..##..##..######..##..##..?
?..##..##..######..##..##..?
?..##..##..######..........?
?..##..##..................?
?..##..............##..##..?
?..##.......####...##..##..?
?..##..##...#..#...######..?
?..##..##...#..#...######..?
????????????????????????????