????????????????????????????
?........##......##........?
?........##......##........?
?..%%%%%%##................?
?..%%%%%%##..........@@@@@@?
?##%%%%%%..................?
?##%%%%%%..................?
?%%%%%%%%......##..#######.?
?%%%%%%%%......##..#######.?
?%%%%%%%%########..##...#..?
?%%%%%%%%######....##...#..?
?%%%%%%%%....##.........#..?
?%%%%%%%%....##.........#..?
?..%%........@@@@@@....%%..?
?..%%........@@@@@@....%%..?
?..................%%%%%%%%?
?..##..##..........%%%%%%%%?
?###..####..#######%%%%%%%%?
?###..####..#......%%%%%%%%?
?..........##......%%%%%%%%?
?..........##..####%%%%%%%%?
?##....@...........%%%%%%..?
?##....@...........%%%%%%..?
?####..@...........%%%%%%..?
?####..@....####...%%%%%%..?
?@@####.....#..#...##......?
?@@####.....#..#...##......?
????????????????????????????
