????????????????????????????
?....##....##......##......?
?....##....##..##..##......?
?%%######..##......###.....?
?%%######..##..@@..###.....?
?%%%%%%....##..##..##...##.?
?%%%%%%........##.......##.?
?%%~~~~~~~~~~~~~~~~~~~~..~~?
?%%~~~~~~~~~~~~~~~~~~~~..~~?
?..##......................?
?..##........####..........?
?....##.....###########@@@@?
?....##.....#####..##......?
?####..##...#####%%##....##?
?####..##...#####%%##@@@@##?
?......@@......%%%%%%%%....?
?......@@..@@..%%%%%%%%....?
?~~~~..~~~~~~~~~~..~~~~~~~~?
?~~~~..~~~~~~~~~~..~~~~~~~~?
?%%%%...#..................?
?%%%%...#....####..........?
?%%%%##..#......#......##..?
?%%%%##..#......#..@@####..?
?%%..##..#.........##..##..?
?%%@@##..#..####.......##..?
?...........#..#.......##..?
?...........#..#...##......?
????????????????????????????