????????????????????????????
?..........................?
?..........................?
?....@@%%@@................?
?....@@%%@@................?
?......%%..%%..............?
?......%%..%%@@............?
?..%%........%%............?
?..%%........%%##..........?
?..%%%%....%%..%%..........?
?..%%%%....%%..%%@@........?
?..%%..%%..%%....%%........?
?..%%..%%..%%....%%##......?
?..%%....%%......%%%%......?
?..%%....%%......%%%%@@....?
?....%%........%%%%%%%%....?
?....%%........%%%%%%%%##..?
?......%%....%%..%%%%%%%%..?
?......%%....%%..%%%%%%%%..?
?##..........%%....%%%%%%@@?
?##..........%%....%%%%%%@@?
?####..........%%..%%%%%%%%?
?####..........%%..%%%%%%%%?
?@@####..........%%..%%%%%%?
?@@####.....####.%%..%%%%%%?
?@@@@####...#..#.%%....%%%%?
?@@@@####...#..#.%%....%%%%?
????????????????????????????