????????????????????????????
?..........................?
?.......##...........##....?
?..##..###.....------####..?
?..##..###.....------####..?
?..##....##..@@----------..?
?..##....##..@@----------..?
?------@.##....##--------..?
?------@.##....##--------..?
?------------####.##.......?
?------------####.##.......?
?.....@--------##.##...@@@@?
?.....@--------##.##.......?
?########--------------####?
?########--------------####?
?......####-------@........?
?......####-------@........?
?..######..------####..##..?
?..######..------####..##..?
?------##--........##..##..?
?------##--........##..##..?
?----------@@..@@......##..?
?----------..........####..?
?##--------........##......?
?##--------.####...##......?
?####@......#..#...##..##..?
?####@......#..#...##..##..?
????????????????????????????