????????????????????????????
?................@@@@@@%%..?
?................@@@@@@%%..?
?..##............@@....@@..?
?..##............@@....@@..?
?##%%##......########..@@..?
?##%%##......########..@@..?
?..##%%##....##..%%##@@@@..?
?..##%%##....##..%%##@@@@..?
?....##..%%@@##%%..##......?
?....##..%%@@##%%..##......?
?........@@..##@@####......?
?........@@..##@@####......?
?....####@@##..@@..........?
?....####@@##..@@..........?
?....##..%%##@@%%..........?
?....##..%%##@@%%..........?
?@@@@@@%%..##....####......?
?@@@@@@%%..##....####......?
?@@..########....##@@@@....?
?@@..########....##@@@@....?
?@@....@@..........@@####..?
?@@....@@..........@@####..?
?%%@@@@@@............##@@@@?
?%%@@@@@@...####.....##@@@@?
?...........#..#.......@@@@?
?...........#..#.......@@@@?
????????????????????????????