????????????????????????????
?....@@..##@@.........#....?
?....@@..##...........#....?
?....##..##%%..########....?
?....##..##%%....######....?
?..%%%%..##%%.##.......@@@@?
?..%%%%..##%%.##.......@@@@?
?%%%%%%%%%%%%######...###..?
?%%%%%%%%%%%%######...###..?
?....%%%%....@@##...#####.#?
?....%%%%####..##...###...#?
?##@@....####......####...#?
?##....##..........##.....#?
?.#....##------------------?
?.#..####------------------?
?.#..##..------------------?
?.#......------------------?
?....@@..------------------?
?....@@..------------------?
?##..##..------------------?
?##..##..------------------?
?.#..##..------------------?
?.#..##..------------------?
?.#..##..........----------?
?.#..##.....####.----------?
?....##.....#..#...--------?
?...........#..#...--------?
????????????????????????????