????????????????????????????
?..........................?
?..........................?
?........##..##............?
?........##..##............?
?%%....%%##%%##%%....%%....?
?%%....%%##%%##%%....%%....?
?##%%%%##########%%%%##%%..?
?##%%%%##########%%%%##%%..?
?########@@##@@########%%..?
?########@@##@@########%%..?
?~~~~~~##########~~~~~~%%..?
?~~~~~~##########~~~~~~%%..?
?~~##################~~~~%%?
?~~##################~~~~%%?
?######~~######~~######%%%%?
?######~~######~~######%%%%?
?####~~~~~~##~~~~~~####~~~~?
?####~~~~~~##~~~~~~####~~~~?
?%%~~~~%%%%%%%%%%~~~~%%~~%%?
?%%~~~~%%%%%%%%%%~~~~%%~~%%?
?..%%%%..........%%%%..%%..?
?..%%%%..........%%%%..%%..?
?..........................?
?...........####...........?
?...........#..#...........?
?...........#..#...........?
????????????????????????????