????????????????????????????
?..........................?
?..........................?
?..##..##..##..##..##..##..?
?..##..##..##..##..##..##..?
?..##..##..##..##..##..##..?
?..##..##..##@@##..##..##..?
?..##..##..##@@##..##..##..?
?..##..##..##..##..##..##..?
?..##..##..........##..##..?
?..##..##..........##..##..?
?..........##..##..........?
?..........##..##..........?
?##..####..........####..##?
?@@..####..........####..@@?
?..........##..##..........?
?..........######..........?
?..##..##..######..##..##..?
?..##..##..##..##..##..##..?
?..##..##..##..##..##..##..?
?..##..##..##..##..##..##..?
?..##..##..........##..##..?
?..##..##..........##..##..?
?..##..##...####...##..##..?
?...........#..#...........?
?...........#..#...........?
????????????????????????????