????????????????????????????
?..%%%%................%%..?
?..%%%%................%%..?
?%%%%......####..........%%?
?%%%%....##########......%%?
?%%.....#############....@@?
?%%.....###############....?
?@@....#################...?
?......#################...?
?.....###......######..#...?
?.....#..........####..#...?
?~~...#..@...@...###.......?
?~~...#..@...@...###.......?
?....##..........###...~~~~?
?....##..####....###...~~~~?
?....################......?
?....################......?
?...##################.....?
?...##################.....?
??..####################...?
?......############........?
?..####..########..####..%%?
?..######..####..######..%%?
?%%..####........####..%%%%?
?%%.........####.......%%%%?
?@@%%.......#..#.....%%%%@@?
?@@%%.......#..#.....%%%%@@?
????????????????????????????
