????????????????????????????
?......##............%%....?
?......##..........@@%%....?
?##............%%.@@@@...##?
?##..........@@%%.@@@@...##?
?........%%.@@@@...@@%%....?
?......@@%%.@@@@.....%%....?
?.....@@@@...@@%%..........?
?.....@@@@.....%%..........?
?......@@%%................?
?........%%................?
?......%%..%%..%%..%%......?
?......%%@@%%..%%@@%%......?
?@@##...@@@@....@@@@...##@@?
?@@##...@@@@....@@@@...##@@?
?......%%@@%%..%%@@%%......?
?......%%..%%..%%..%%......?
?..........................?
?........@@......@@........?
?##.....@@@@....@@@@.....##?
?##.....@@@@....@@@@.....##?
?##....%%@@%%..%%@@%%....##?
?##....%%..%%..%%..%%....##?
?..........................?
?....##.....####.....##....?
?....####...#..#...####....?
?....####...#..#...####....?
????????????????????????????