????????????????????????????
?..........................?
?........##......##........?
?..########......########..?
?..########......########..?
?..##........##........@@..?
?..##........##........@@..?
?..##..####......####..####?
?..##..##..........##..####?
?..##..#.%%..@@..%%.#..@@##?
?..##..#.%%@@@@@@%%.#..@@##?
?..##....%%%%%%%%%%....@@##?
?........%%%%%%%%%%......##?
?##......%%%%%%%%%%......##?
?##@@....%%%%%%%%%%....####?
?##@@..#.%%@@@@@@%%.#..##..?
?##@@..#.%%..@@..%%.#..##..?
?####..##..........##..@@..?
?####..####......####..@@..?
?##@@........##........##..?
?##@@........##........##..?
?##########......######@@@@?
?##########......######@@@@?
?####....##......##....##..?
?####.......####.......##..?
?####.......#..#...........?
?####.......#..#...........?
????????????????????????????