????????????????????????????
?....................##....?
?....................##....?
?..##~~~~..@@..##..........?
?..##~~~~..@@..##..........?
?...~~~~##%%%%%%~~~~..@@...?
?...~~~~##%%%%%%~~~~..@@...?
?...%%......%%%%%%~~~~##...?
?...%%......%%%%%%~~~~##...?
?..@@....~~~~..%%..........?
?..@@....~~~~..%%..........?
?%%%%##..~~~~@@........##..?
?%%%%##..~~~~@@........##..?
?%%%%%%............@@....@@?
?%%%%%%............@@....@@?
?..##~~~~..##..............?
?..##~~~~..##..............?
?@@..~~~~%%%%~~~~%%%%..##..?
?@@..~~~~%%%%~~~~%%%%..##..?
?........%%..~~~~%%%%~~~~..?
?........%%..~~~~%%%%~~~~..?
?......@@%%......%%%%~~~~..?
?......@@%%......%%%%~~~~..?
?....##..##................?
?....##..##.####...........?
?##.........#..#...##@@....?
?##.........#..#...##@@....?
????????????????????????????
