????????????????????????????
?..........................?
?..........................?
?..........................?
?..........####......@@....?
?..........%%%%......%%....?
?..@@@@..##%%%%@@..##%%##..?
?..%%%%..%%%%%%%%..%%%%%%..?
?##%%%%##%%%%%%%%##%%%%%%##?
?%%%%%%%%%%%%%%%%%%%%%%%%%%?
?%%%%%%%%%%%%%%%%%%%%%%%%%%?
?@@%%~~%%%%%%%%%%~~%%%%%%%%?
?@@%%~~%%%%%%%%%%~~%%%%%%%%?
?%%%%~~~~~~%%%%%%~~~~~~%%@@?
?%%%%~~~~~~%%%%%%~~~~~~%%@@?
?%%%%%%%%~~%%@@%%%%%%~~%%%%?
?%%%%%%%%~~%%@@%%%%%%~~%%%%?
?%%%%%%%%%%%%%%%%%%%%%%%%%%?
?%%%%%%%%%%%%%%%%%%%%%%%%%%?
?%%%%%%%%%%####%%%%%%%%%%@@?
?%%%%%%%%%%....%%%%%%%%%%..?
?@@%%%%%%##....##%%%%%%@@..?
?..%%%%%%........%%%%%%....?
?..@@####........######....?
?..........####............?
?..........#..#............?
?..........#..#............?
????????????????????????????