????????????????????????????
?------------..------------?
?------------..------------?
?--------------------------?
?--------------------------?
?------##----------##------?
?------##----------##------?
?--##..##..##--##..##..##--?
?--##..##..##--##..##..##--?
?--######..........######--?
?--....##..........##------?
?------##..##@@##..##------?
?------######@@######------?
?@@------..@@..@@..------@@?
?@@------..........------@@?
?--------..........--------?
?--------..##..##..--------?
?--------..##..##..--------?
?--------..##..##..--------?
?------##..........##------?
?------##....##....##------?
?--##--##..@@@@@@..##--##--?
?--##--##..........##--##--?
?..##..##..........##..##..?
?..######...####...######..?
?..##.......#..#.......##..?
?...........#..#...........?
????????????????????????????
