????????????????????????????
?........@@........@@......?
?........@@........@@......?
?..@@......@@....@@%%%%....?
?..@@......@@....@@%%%%....?
?....@@........@@%%..@.....?
?....@@........@@%%@@@.....?
?......@@..%%%%%%%%%%...@..?
?......@@..%%%%%%%%%%...@..?
?..@.....@@%%%%@@%%....@@..?
?..@.....@@%%%%@@%%....@@..?
?..@@@.%%..@@%%%%@@.....@..?
?....@.%%..@@%%%%@@.....@..?
?....%%%%%%%%%%....@@......?
?....%%%%%%%%%%....@@......?
?....@.%%..@@%%......@@....?
?..@@@.%%..@@%%......@@....?
?..%%%%%%@@..@@........@@..?
?..%%%%%%@@..@@..@@....@@..?
?%%%%%%@@.........@........?
?%%%%%%@@.........@........?
?....@@.................@@@?
?....@@.................@@@?
?....................@.....?
?...........####...@@@.....?
?@..........#..#...........?
?@...@@.....#..#...........?
????????????????????????????